1111111111111
10010E00PC001
1000001111001
1010110000001
1111111111111
