1111111111111111111111111111111111
1E00000000000000000000000000000001
1010111010010000010100100000001011
1011C10010101010001001000000010101
1P1000000C0000000000000000000000C1
1111111111111111111111111111111111
