1111111111111
1C010E01PC101
1000001110101
1010110000001
1111111111111
