1111111111111
1C010E01PC1C1
1000011110101
1C10000000001
1111111111111
