1111111111111111111111111111111111
1E00000000000000000000000000000001
1010111010010000010100100000001C11
1011C10010101010001001000000010101
1P1000000C000000000000000000000001
1111111111111111111111111111111111
