111111111111111111111111111111111
11000110000000000P000000000000111
100011100000000000000000000000001
100000000100000000000000000000001
100000001E00000000000001000000001
100000000100000000000000000000001
10000000000000000C000000000000001
100000000000000000000000000000001
111111111111111111111111111111111
